0000010000000000000000000009010000000000000000008
0000010000300000000000000000010000000000000020000
0000010000000000000000000000010000000000000000000
0000010000000000000000000000010000000000000200000
0000010000000000000000000000010000000000000000000
0000010000000000000000000000010000000000000000000
0000010000000000000000000000010000000000000000000
0000010000000000000000000000011111111111111111111
0000010000000000000000000000000000000000000000000
0000010000000000000000000000000000000000000000900
0000010000000000000000000000000000000000000000000
0000000000000000000000000000000000000000000000000
0000000000000000000000000000000000000000000000000
0000000000000000000000000000000000000000000000000
0000000000000000000000000000000000000000000000000
0000000000000000000000000000000000000000000000000
0000000000000000000000000000000000000000000000000
1111111111110000000000000001000000000000000000000
0000060000010000000000000000100040000000000000000
0000000000010000000000000000010000000000000000000
0000000000010000000000000000001020000000000000000
4000000000010000000000000000000010000000000000000
0000000000010000000000000000000001000000000000000
0000000000010000000000000000000000104000000000000
4000000000010000000000000000000000010000000000000
0000000000010000000000000000000000001040000000000
9000000000010000000000000000000000000100000000000
0000000000410000000000000000000000000011020000000
0000000000010000000000000000000000000000100000000
0000000000010000000000000000000000000000010000000
0000000000010000000000000000000000000000011000000
0000000000410000000000000000000000000000000102000
0000000000010000000000000000000000000000000110070
0000000000010000000000000000000000000000000001000
0000000000010000000000000000000000000000000000100
0000000000010000000090000000090000000000000000100
0000000000010000000000000000000000000000000000010
0000000000010000000000000000000000000000000009001
0000000000000000000000000000000000000000000000000
0000000000000000000030000000000000300000005000000